1,1,1,1,1,1,1,1,1
1,0,0,0,0,0,0,1,0
1,0,2,0,0,3,7,1,3
1,0,7,0,0,6,6,1,4
1,0,7,0,5,7,0,1,1
1,1,7,7,1,1,1,7,0
7,1,7,7,4,7,1,1,0